16 16 16 16 16 16 16 16 16 16 16 16 16 16 16 16 
16 1 16 16 16 16 16 16 16 1 1 1 1 1 16 16 
16 1 1 1 1 1 1 1 1 1 1 1 1 1 1 16 
16 1 1 1 1 1 1 1 1 1 1 1 1 1 1 16 
16 1 1 1 1 1 1 1 1 1 1 1 1 1 1 16 
16 1 1 2 2 2 2 2 2 2 1 1 1 1 1 16 
16 1 1 2 2 2 2 2 2 2 17 17 17 17 17 17 
16 1 1 2 2 2 2 2 2 2 2 17 17 17 17 17 
16 1 1 1 2 2 2 2 2 1 1 1 1 1 1 16 
16 1 1 1 1 1 1 1 1 1 1 1 1 1 1 16 
16 1 1 1 1 1 1 1 16 16 16 16 16 1 1 16 
16 16 16 16 16 16 16 16 16 16 16 16 16 16 16 16 
