127 0 0 0 127 0 127 1 127 1 127 1 127 1 127 1 127 1 127 1 127 1 127 1 127 1 127 0 16 0 127 0 
127 0 1 1 0 0 16 0 0 0 0 0 0 0 0 0 0 0 0 0 0 0 0 0 16 0 0 0 1 1 127 0 
127 0 1 1 1 1 1 1 1 1 1 1 1 1 1 1 1 1 1 1 1 1 1 1 1 1 1 1 1 1 127 0 
127 0 1 1 1 1 1 1 18 0 18 0 18 0 18 0 18 0 1 1 1 1 1 1 1 1 1 1 1 1 127 0 
127 0 1 1 1 1 18 0 2 1 2 1 2 1 2 1 2 1 18 0 1 1 1 1 1 1 1 1 1 1 16 0 
127 0 1 1 1 1 2 0 2 1 2 1 2 1 2 1 2 1 2 1 18 0 18 0 17 1 17 1 17 1 17 1 
127 0 1 1 1 1 1 1 2 0 2 0 2 1 2 1 2 1 2 1 2 1 2 0 18 0 17 1 17 1 17 1 
127 0 1 1 1 1 1 1 1 1 1 1 2 0 2 0 2 0 2 0 2 0 1 1 1 1 1 1 1 1 127 0 
127 0 1 1 1 1 1 1 1 1 1 1 1 1 1 1 1 1 1 1 1 1 1 1 1 1 1 1 1 1 127 0 
127 0 1 1 1 1 1 1 1 1 1 1 1 1 1 1 1 1 1 1 1 1 1 1 1 1 1 1 1 1 127 0 
127 0 1 1 1 1 1 1 1 1 1 1 1 1 1 1 1 1 1 1 1 1 1 1 1 1 1 1 1 1 127 0 
127 0 127 0 127 0 127 0 127 0 127 0 127 0 127 0 127 0 127 0 127 0 127 0 127 0 127 0 127 0 127 0 
